8 8 15
-1 0 0 0 0 0 -1 0
-1 S -1 0 0 0 2 0
0 4 0 -1 -1 0 0 0
0 0 0 0 -1 0 -1 0
-1 0 2 -1 3 0 0 0
0 0 0 0 -1 2 3 3
0 0 7 0 0 0 0 G
0 -1 0 -1 0 9 0 0