20 20 0 0
0 0 0 0 0 0 -1 -1 0 0 0 0 -1 0 0 G -1 0 0 0
-1 0 0 0 -1 0 0 0 0 0 0 0 0 0 0 0 0 -1 0 0
0 0 0 -1 0 0 0 -1 0 0 -1 0 -1 0 -1 0 0 -1 0 0
0 0 0 0 0 0 -1 0 0 0 0 -1 0 -1 -1 0 0 -1 0 0
0 0 0 -1 0 -1 0 0 -1 -1 0 0 0 0 0 0 -1 0 0 0
0 -1 0 0 4 0 0 0 -1 0 0 0 -1 0 0 0 0 -1 0 0
0 0 0 0 0 -1 0 -1 0 0 0 0 0 0 0 0 0 -1 0 0
-1 0 -1 0 0 0 -1 0 0 -1 0 -1 0 0 -1 0 -1 -1 0 -1
0 0 0 0 0 0 0 0 0 0 0 -1 0 0 0 0 0 0 0 0
0 0 -1 0 0 0 -1 0 0 0 0 0 0 -1 0 0 0 0 -1 -1
0 0 0 5 0 0 0 0 0 0 -1 0 0 0 0 -1 0 0 -1 0
0 0 0 0 0 0 0 -1 0 0 0 0 0 0 0 0 0 -1 0 0
0 0 -1 S -1 -1 0 0 0 0 0 0 0 0 -1 -1 0 0 -1 0
-1 0 0 -1 0 0 -1 0 -1 0 0 0 0 -1 -1 0 -1 0 0 0
-1 0 0 0 0 0 0 0 0 0 0 0 -1 0 0 0 0 0 0 0
0 0 0 0 0 0 0 -1 0 0 0 0 0 0 0 -1 0 0 0 0
0 0 0 0 -1 -1 0 0 0 0 0 0 0 0 0 0 0 0 0 0
0 0 0 0 0 0 -1 -1 0 F1 0 -1 0 -1 0 0 0 -1 0 0
0 0 -1 0 0 0 0 0 -1 0 0 0 0 0 0 0 0 -1 0 0
0 0 0 0 0 0 0 -1 0 0 0 0 -1 -1 0 0 0 -1 0 0