20 20 30 0
0 0 0 0 0 0 -1 -1 0 0 0 0 -1 0 0 -1 -1 0 0 0
-1 0 0 0 -1 0 0 0 0 0 0 30 0 0 5 0 0 -1 0 0
0 0 0 -1 0 0 0 -1 0 0 -1 0 -1 0 -1 0 0 -1 0 0
0 0 0 0 0 0 -1 0 0 0 0 -1 0 -1 -1 0 G -1 0 0
0 0 0 -1 0 -1 0 0 -1 -1 0 0 -1 0 0 0 -1 0 0 0
0 -1 0 0 4 0 0 0 -1 0 0 0 -1 0 0 0 0 -1 0 0
0 0 0 0 0 -1 0 -1 0 0 0 0 0 20 10 0 0 -1 0 0
-1 0 -1 0 0 0 -1 0 1 -1 0 -1 0 0 -1 1 -1 -1 0 -1
0 0 0 0 0 0 0 0 0 0 0 -1 7 0 10 0 0 0 0 0
0 0 -1 0 0 0 -1 2 0 0 0 0 0 -1 0 0 0 0 -1 -1
0 0 0 5 0 0 0 0 0 0 -1 0 0 0 0 -1 0 0 -1 0
0 0 0 0 0 0 0 -1 0 0 0 0 5 0 0 0 0 -1 0 0
0 0 -1 S -1 -1 0 0 0 0 0 0 0 0 -1 -1 0 0 -1 0
-1 0 0 -1 0 0 -1 0 -1 0 0 0 5 -1 -1 0 -1 0 0 0
-1 0 0 0 0 0 0 0 0 0 0 0 -1 0 0 0 0 0 0 0
0 0 0 0 0 0 0 -1 0 0 0 0 0 0 0 -1 0 0 0 0
0 0 0 3 -1 -1 0 0 0 0 0 0 0 0 0 0 0 0 0 0
0 0 0 0 0 0 -1 -1 0 F1 0 -1 0 -1 0 0 0 -1 0 0
0 0 -1 0 0 0 0 0 -1 0 4 0 0 0 0 0 0 -1 0 0
0 0 0 0 0 0 0 -1 0 0 0 0 -1 -1 0 0 0 -1 0 0