10 10 
0 0 0 -1 -1 0 0 0 0 0
0 S 0 0 0 0 0 -1 0 -1
0 0 -1 0 0 0 0 -1 0 -1
0 0 0 0 -1 0 0 -1 0 0
0 0 -1 0 -1 0 -1 -1 -1 0
1 0 -1 0 0 0 0 0 -1 0
0 0 0 0 -1 0 -1 0 -1 0
0 0 0 0 -1 0 -1 0 G 0
0 -1 -1 -1 -1 0 0 0 0 0
-1 0 0 0 0 0 -1 -1 -1 0