7 4 14 0
S 0 0 0
0 -1 0 4
1 0 2 0
0 -1 5 1
-1 0 0 0
0 G 0 -1
0 0 5 -1