20 20 30 15
0 0 0 0 0 0 -1 -1 0 0 0 0 -1 0 0 -1 -1 0 0 0
-1 0 0 0 -1 0 0 0 0 0 0 30 0 0 5 0 0 -1 0 0
0 0 0 -1 G 0 0 -1 0 0 -1 0 -1 0 -1 0 F2 -1 0 0
0 0 0 0 0 0 -1 0 0 0 0 -1 0 -1 -1 0 -1 -1 0 0
F2 0 25 -1 -1 -1 0 0 -1 -1 0 0 -1 0 0 0 -1 0 0 0
0 -1 F1 0 4 0 0 0 F1 0 0 0 -1 0 0 0 0 -1 0 0
0 0 0 0 0 -1 0 -1 0 0 0 0 0 2 9 0 0 -1 0 0
-1 0 -1 0 0 0 -1 0 1 -1 0 -1 0 0 -1 1 -1 -1 0 -1
0 0 0 0 F1 0 9 0 0 0 0 -1 7 0 9 0 0 0 0 0
0 0 -1 0 0 0 -1 2 0 0 0 0 0 -1 0 0 0 0 -1 -1
2 0 0 5 0 0 0 0 0 0 -1 0 0 0 0 -1 0 0 -1 0
0 0 0 0 0 0 0 -1 0 F1 0 0 5 0 0 0 0 -1 0 0
0 0 -1 S 2 -1 0 0 0 0 0 0 0 0 -1 -1 0 0 -1 0
-1 0 0 -1 0 0 -1 0 -1 0 0 0 5 -1 -1 0 -1 0 0 0
-1 0 0 0 0 0 0 0 0 F1 0 0 -1 0 0 0 0 0 0 0
0 0 0 0 0 0 0 -1 0 0 0 0 0 0 0 -1 0 0 0 0
0 0 0 3 -1 -1 0 0 0 0 F2 0 0 0 0 0 0 0 0 0
0 0 0 0 0 0 -1 -1 0 F1 0 -1 0 -1 0 0 0 -1 0 0
0 0 -1 0 0 0 0 0 -1 0 4 0 0 0 0 0 0 -1 0 0
0 0 0 0 0 0 0 -1 0 0 0 0 -1 -1 0 0 0 -1 0 0