10 10 18 0
-1 0 0 -1 0 0 5 -1 0 0
0 -1 0 -1 -1 -1 -1 -1 -1 0
0 8 0 0 4 0 0 -1 0 0
-1 0 3 0 0 G 0 0 0 0
-1 0 -1 0 6 -1 0 0 -1 0
0 0 -1 -1 0 0 10 0 -1 0
0 -1 0 0 -1 -1 0 0 0 0
0 1 0 3 0 5 0 5 0 0
0 -1 S 0 1 -1 2 0 -1 0
0 0 -1 0 2 0 0 0 0 -1